1111111111111111111111111111111111
100000000000000E000000100000000001
1010010100100000101001000000010101
1010010010101010001001000000010101
1000000000000000C0000000P000000001
1111111111111111111111111111111111